11x10
**********
*        *
*   H    *
*        *
*        *
*   *    *
*        *
*        *
*   R    *
*        *
**********