15x20
*****************O**
*    R         + R *
*  *   ****    +   *
*  *           +   *
*  *     R       R *
*                  *
*   H    +++++     *
*                  *
*            R     *
*     ****         *
*       R    +     *
*            +     *
*   R        +     *
*            +  R  O
*************+******