15x20
********************
*    R         * R *
*  *   ****    *   *
*  *           *   *
*  *     R       R *
*                  *
*   H    *****     *
*                  *
*            R     *
*     ****         *
*       R    *     *
*            *     *
*   R        *     *
*               R  *
********************